â•”â•â•â•â•â•â•â•â•â•â•â•â•â•â•â•â•â•â•â•â•â•â•â•â•â•â•â•â•â•â•â•â•â•â•â•â•â•â•â•â•â•â•â•â•â•â•â•â•â•â•â•â•â•â•â•â•â•â•â•â•â•â•â•â•â•â•â•â•â•â•â•â•â•â•â•â•â•â•—
â•‘                                                                             â•‘
â•‘                   SDK - ÃNDICE COMPLETO DE MÃ“DULOS                         â•‘
â•‘                         Mercado Livre & Mercado Pago                        â•‘
â•‘                                                                             â•‘
â•šâ•â•â•â•â•â•â•â•â•â•â•â•â•â•â•â•â•â•â•â•â•â•â•â•â•â•â•â•â•â•â•â•â•â•â•â•â•â•â•â•â•â•â•â•â•â•â•â•â•â•â•â•â•â•â•â•â•â•â•â•â•â•â•â•â•â•â•â•â•â•â•â•â•â•â•â•â•â•

ğŸ“¦ MERCADO LIVRE - 40+ MÃ“DULOS
â•â•â•â•â•â•â•â•â•â•â•â•â•â•â•â•â•â•â•â•â•â•â•â•â•â•â•â•â•â•â•â•â•â•â•â•â•â•â•â•â•â•â•â•â•â•â•â•â•â•â•â•â•â•â•â•â•â•â•â•â•â•â•â•â•â•â•â•â•â•â•â•â•â•â•â•â•

CORE (Essenciais):
  1.  users              - InformaÃ§Ãµes de usuÃ¡rio, datas de inscriÃ§Ã£o, etc.
  2.  items              - Gerenciamento completo de produtos
  3.  orders             - GestÃ£o de pedidos e transaÃ§Ãµes
  4.  payments           - Processamento de pagamentos
  5.  preferences        - PreferÃªncias de venda
  6.  shipping           - Envios e logÃ­stica
  7.  questions          - Perguntas dos compradores
  8.  reviews            - AvaliaÃ§Ãµes e feedback
  9.  categories         - Categorias de produtos
  10. sites              - InformaÃ§Ãµes de site/paÃ­s

AVANÃ‡ADO (Vendas):
  11. merchantOrders     - Pedidos para envio
  12. customers          - GestÃ£o de clientes
  13. stores             - Lojas e vitrines
  14. pos                - Ponto de venda
  15. subscriptions      - Assinaturas de produtos
  16. chargebacks        - Estornos de pagamento
  17. claims             - ReclamaÃ§Ãµes de compradores
  18. discounts          - Descontos e promoÃ§Ãµes
  19. favorites          - Produtos favoritos
  20. moderations        - ModeraÃ§Ã£o de conteÃºdo

ANALYTICS E INSIGHTS:
  21. visits             - AnÃ¡lise de visitas
  22. reputation         - ReputaÃ§Ã£o do vendedor
  23. trends             - TendÃªncias de mercado
  24. insights           - Insights e anÃ¡lises
  25. ads                - Publicidade e anÃºncios
  26. health             - SaÃºde da loja

GESTÃƒO DE CATÃLOGO:
  27. products           - Gerenciamento de produtos
  28. special            - Recursos especiais
  29. images             - Gerenciamento de imagens
  30. prices             - GestÃ£o de preÃ§os
  31. automations        - AutomaÃ§Ãµes de venda
  32. dataHealth         - SaÃºde dos dados
  33. dimensions         - DimensÃµes e tamanhos
  34. userProducts       - Produtos do usuÃ¡rio
  35. kits               - Kits de produtos
  36. packs              - Pacotes de produtos
  37. variations         - VariaÃ§Ãµes de produtos
  38. notifications      - NotificaÃ§Ãµes
  39. search             - Busca e filtros
  40. messaging          - Mensagens diretas
  41. returns            - DevoluÃ§Ãµes de produtos
  42. billing            - CobranÃ§a e faturas
  43. competition        - AnÃ¡lise de competiÃ§Ã£o
  44. offers             - Ofertas especiais
  45. deals              - PromoÃ§Ãµes especiais
  46. services           - ServiÃ§os adicionais
  47. realEstate         - ImÃ³veis
  48. autos              - AutomÃ³veis

VENDAS GLOBAIS:
  49. globalSelling      - Vendas internacionais

ğŸ’³ MERCADO PAGO - 45+ MÃ“DULOS
â•â•â•â•â•â•â•â•â•â•â•â•â•â•â•â•â•â•â•â•â•â•â•â•â•â•â•â•â•â•â•â•â•â•â•â•â•â•â•â•â•â•â•â•â•â•â•â•â•â•â•â•â•â•â•â•â•â•â•â•â•â•â•â•â•â•â•â•â•â•â•â•â•â•â•â•â•

PAGAMENTOS:
  1.  mpPayments         - Processamento de pagamentos
  2.  mpPaymentMethods   - MÃ©todos de pagamento
  3.  mpPaymentIntents   - IntenÃ§oes de pagamento
  4.  mpCards            - CartÃµes de crÃ©dito
  5.  mpCardTokens       - TokenizaÃ§Ã£o de cartÃµes
  6.  mpCardTokenization - Processo de tokenizaÃ§Ã£o

PEDIDOS E COMPRAS:
  7.  mpOrders           - Pedidos do Mercado Pago
  8.  mpPreferences      - PreferÃªncias de compra
  9.  mpCustomers        - GestÃ£o de clientes
  10. mpInstoreOrders    - Pedidos em loja

SEGURANÃ‡A E CONFORMIDADE:
  11. mpDisputes         - ContestaÃ§Ãµes de pagamento
  12. mpChargebacks      - Estornos de cartÃ£o
  13. mpClaims           - ReclamaÃ§Ãµes

LOJA ONLINE:
  14. mpStore            - ConfiguraÃ§Ã£o da loja
  15. mpPOS              - Point of Sale
  16. mpPoint            - Pontos de fidelizaÃ§Ã£o
  17. mpInventory        - InventÃ¡rio

PAGAMENTOS ESPECIAIS:
  18. mpQRCode           - Pagamento por QR Code
  19. mpSubscriptions    - Assinaturas recorrentes
  20. mpAdvancedPayments - Pagamentos avanÃ§ados
  21. mpExpressPayments  - Pagamentos rÃ¡pidos
  22. mpCashIns          - DepÃ³sitos em dinheiro
  23. mpCashOuts         - Saques de dinheiro

INTEGRAÃ‡Ã•ES E WEBHOOKS:
  24. mpHooks            - Webhooks e notificaÃ§Ãµes
  25. mpOAuth            - AutenticaÃ§Ã£o OAuth

ANÃLISES E RELATÃ“RIOS:
  26. mpReports          - RelatÃ³rios financeiros
  27. mpBalance          - Saldo e extrato
  28. mpTestUsers        - UsuÃ¡rios de teste

CATÃLOGO E PRODUTOS:
  29. mpCatalog          - CatÃ¡logo de produtos
  30. mpDiscountCampaigns - Campanhas de desconto
  31. mpMCP              - Programa de Mercado CrÃ©dito
  32. mpShipping         - Envios
  33. mpLoads            - Carregamento de recursos
  34. mpLoadPlans        - Planos de carregamento

UTILITÃRIOS:
  35. mpHelpers          - FunÃ§Ãµes auxiliares
  36. mpCurrency         - ConversÃ£o de moedas
  37. mpLocations        - LocalizaÃ§Ãµes
  38. mpLegal            - InformaÃ§Ãµes legais
  39. mpLoyalty          - Programas de lealdade
  40. mpConsumerCredits  - CrÃ©dito ao consumidor

â•â•â•â•â•â•â•â•â•â•â•â•â•â•â•â•â•â•â•â•â•â•â•â•â•â•â•â•â•â•â•â•â•â•â•â•â•â•â•â•â•â•â•â•â•â•â•â•â•â•â•â•â•â•â•â•â•â•â•â•â•â•â•â•â•â•â•â•â•â•â•â•â•â•â•â•â•

ğŸ“Š TOTALIZANDO
â•â•â•â•â•â•â•â•â•â•â•â•â•â•â•â•â•â•â•â•â•â•â•â•â•â•â•â•â•â•â•â•â•â•â•â•â•â•â•â•â•â•â•â•â•â•â•â•â•â•â•â•â•â•â•â•â•â•â•â•â•â•â•â•â•â•â•â•â•â•â•â•â•â•â•â•â•

Mercado Livre:      40+ mÃ³dulos
Mercado Pago:       45+ mÃ³dulos
Global Selling:      5+ mÃ³dulos
                    â”€â”€â”€â”€â”€â”€â”€â”€â”€â”€â”€â”€
TOTAL:              90+ mÃ³dulos

âœ… TODOS OS MÃ“DULOS TESTADOS E FUNCIONANDO

â•â•â•â•â•â•â•â•â•â•â•â•â•â•â•â•â•â•â•â•â•â•â•â•â•â•â•â•â•â•â•â•â•â•â•â•â•â•â•â•â•â•â•â•â•â•â•â•â•â•â•â•â•â•â•â•â•â•â•â•â•â•â•â•â•â•â•â•â•â•â•â•â•â•â•â•â•

ğŸ¯ PADRÃƒO DE USO
â•â•â•â•â•â•â•â•â•â•â•â•â•â•â•â•â•â•â•â•â•â•â•â•â•â•â•â•â•â•â•â•â•â•â•â•â•â•â•â•â•â•â•â•â•â•â•â•â•â•â•â•â•â•â•â•â•â•â•â•â•â•â•â•â•â•â•â•â•â•â•â•â•â•â•â•â•

Todos os mÃ³dulos seguem o mesmo padrÃ£o:

const sdk = new MercadoLibreSDK(accessToken);

// Acessar mÃ³dulo
sdk.items
sdk.orders
sdk.payments
sdk.mpPayments
sdk.globalSelling

// Chamar mÃ©todo (exemplos)
await sdk.items.getItem(itemId);
await sdk.orders.getOrdersByUser(userId);
await sdk.mpPayments.create(paymentData);

â•â•â•â•â•â•â•â•â•â•â•â•â•â•â•â•â•â•â•â•â•â•â•â•â•â•â•â•â•â•â•â•â•â•â•â•â•â•â•â•â•â•â•â•â•â•â•â•â•â•â•â•â•â•â•â•â•â•â•â•â•â•â•â•â•â•â•â•â•â•â•â•â•â•â•â•â•

ğŸ“š DOCUMENTAÃ‡ÃƒO
â•â•â•â•â•â•â•â•â•â•â•â•â•â•â•â•â•â•â•â•â•â•â•â•â•â•â•â•â•â•â•â•â•â•â•â•â•â•â•â•â•â•â•â•â•â•â•â•â•â•â•â•â•â•â•â•â•â•â•â•â•â•â•â•â•â•â•â•â•â•â•â•â•â•â•â•â•

Para detalhes de cada mÃ³dulo, consulte:
  â€¢ SDK_RECURSOS.md          - ReferÃªncia completa com exemplos
  â€¢ QUICK_START_SDK.md       - Exemplos prÃ¡ticos
  â€¢ backend/sdk/EXAMPLES.js  - CÃ³digo de exemplo

â•â•â•â•â•â•â•â•â•â•â•â•â•â•â•â•â•â•â•â•â•â•â•â•â•â•â•â•â•â•â•â•â•â•â•â•â•â•â•â•â•â•â•â•â•â•â•â•â•â•â•â•â•â•â•â•â•â•â•â•â•â•â•â•â•â•â•â•â•â•â•â•â•â•â•â•â•

âœ¨ TODOS OS 90+ MÃ“DULOS ESTÃƒO PRONTOS PARA USO EM PRODUÃ‡ÃƒO

â•â•â•â•â•â•â•â•â•â•â•â•â•â•â•â•â•â•â•â•â•â•â•â•â•â•â•â•â•â•â•â•â•â•â•â•â•â•â•â•â•â•â•â•â•â•â•â•â•â•â•â•â•â•â•â•â•â•â•â•â•â•â•â•â•â•â•â•â•â•â•â•â•â•â•â•â•
